111111111111111111111111111111111111111111111111111111111111111111111111111
111110000100000000000000000000000000000000000000000000000000000000000000001
110R00E0000111000000000000000000B000000000000000000000000011111000000000001
1000M000000011000000000000000000000000000000000R0000000000R1111110000000001
100G011000G000000000000000000000000C00000000000BB00000000000011000000000001
100X0001000000000000000000000000000000000000000000C0000B0000000000000000001
1000000000000C000000000000000000000000000000000000000000CC00000000000000001
1000R0000000000000000000C000000000000000000000000000000000000000010M00G0001
10000001000G00B0000000000000111100000000000000000BB000000000000011100C00001
10000100000C0001100000001111110000000000RB00000000B000000000G00000C0000C001
111110000000000010000000011000111100000000000000000000000P00011100000C00011
100110110R0000001110000000000000000000000M0000000000000000000001100000R1111
111111111111111111111111111111111111111111111111111111111111111111111111111