11111111111111111111111
1000C0100000000000001C1
1011011011111010G010001
10G00000P10100100111111
101100111100011110C00E1
10110C00110101000010111
10001100000101011110101
11100001111X00000000001
11111111111111111111111