1111111111111111111111111
11100BGG000000000X0011111
100M00000C01000BB0C0000E1
11100X0B0P0000BBB0000B001
11111B00100XG00000M0BB111
1111111111111111111111111