1111111111111111
10000P0001000001
100E0000C0000C01
1111111111111111