1111111111111111111111111
1110000000000000000011111
1000000000000000000000001
1110000000000000000000001
1111100000000000000000111
1111111111111111111111111