1111111111111111111111111
111000000000E0000X0011111
100000000C00000000C000001
111000000P000000000000001
11111000000X000G000000111
1111111111111111111111111