1111111111111111111111111
111000GG00T000000X0011111
10000T000C01M00BB0C0000E1
11100X0B0P0000BBB0000T001
11111B00100XG00000T000111
1111111111111111111111111