1111111111111
1110000000001
1P0001C00UE01
1111111111111