1111111111111111111111111
1110000000000000000011111
100000000C00000000C000001
111000000P000000000000001
1111100000000000000000111
1111111111111111111111111